8 8
  ###   
  #$#   
### ####
#  * *$#
#$ *0 ##
##     #
##1  *$#
 ##2####
