9 9
   ######
####   ##
#   0  ##
# **# #$#
##     $#
#   *  $#
#   3  ##
###    1#
  #######
